WWWWWWWWWWWWWWW
WO-OO---OO----W
W-------------W
W-R---------1-W
W-W-WOW-W-W-W-W
W----OO-------W
W-WOWOWOWOWOW-W
W--OO---------W
W-W-W-W-W-W-W-W
WW-W-WW-WW-W-WW
WW-W-WW-WW-W-WW
W----------O--W
W-W-W-W-W-WOWOW
W--2----------W
WWWWWWWWWWWWWWW