WWWWWWWWWW
W--OW--O-W
WR-WWOW--W
W-1--RW--W
W--O--W--W
W-2-O-WO-W
WOWO---WOW
W---OO-WRW
W--3OO---W
WWWWWWWWWW