WWWWWWWWWWWWWWWWWWW
W--O-OO---OO------W
W-W-W-WOW-W-W-W-WOW
W---R---------1---W
W-W-W-W-W-WO-W-W-WW
W-----------------W
W-W-W-WOW-W-W-W-WOW
W------OO----R----W
W-W-WOWOWOWOWOW-W-W
W----OO---------3-W
W-W-W-W-W-W-W-W-W-W
W-----O-----------W
W-W-W-W-W-W--W-W-WW
W---R-------WO----W
WOW-W-W---W-WOWOWOW
WO-----OOO--------W
WWW-W-W-WO-W-W-W-WW
W----2-------R----W
WWWWWWWWWWWWWWWWWWW