WWWWWWW
W--OW-W
WR-WWOW
W-1--RW
W--O-3W
W-2OO-W
WWWWWWW