# LN
# GD
# ET
# ED
# ER
# RS
# PR
# PO
# GRID LAYOUT
WWWWWWWWWWWWWWWWWWW
W-2-----R----O----W
WWOW-W-W-W-W-W-W-WW
W-O--------R------W
WWOWOW-W-W-W-WOW-WW
W--O--------O-R--3W
WWOW-W-W-W-W-W-W-WW
W-OOOO---1-------OW
WWOWOWOWOW-W-W-W-WW
W--0000--R--OOO---W
WW-W-WOWOW-WOWOWOWW
W------OOO--OOO-ORW
WWWWWWWWWWWWWWWWWWW