WWWWWWWWWWWWWWW
WO-OO---OO----W
W-W-WOW-W-W-W-W
W-R---------1-W
W-W-WOW-W-W-W-W
W----OO----R--W
W-WOWOWOWOWOW-W
W--OO---------W
W-W-W-W-W-W-W-W
W---O---------W
W-W-W-W-W-W-W-W
W-R--------O--W
W-W-W-W-W-WOWOW
W--2-------R--W
WWWWWWWWWWWWWWW